{
  "maps": [
    {
      "id": "plains",
      "name": "Open Plains",
      "description": "A wide-open battlefield with scattered cover.",
      "width": 15,
      "height": 10,
      "grid": [
        [0,0,0,0,0,0,0,0,0,0,0,0,0,0,0],
        [0,0,0,0,0,0,0,0,0,0,0,0,0,0,0],
        [0,0,1,0,0,0,0,0,0,0,0,0,1,0,0],
        [0,0,0,0,0,1,0,0,0,1,0,0,0,0,0],
        [0,0,0,1,0,0,0,0,0,0,0,1,0,0,0],
        [0,0,0,0,0,0,0,0,0,0,0,0,0,0,0],
        [0,0,0,0,0,1,0,0,0,1,0,0,0,0,0],
        [0,0,1,0,0,0,0,0,0,0,0,0,1,0,0],
        [0,0,0,0,0,0,0,0,0,0,0,0,0,0,0],
        [0,0,0,0,0,0,0,0,0,0,0,0,0,0,0]
      ],
      "spawn_team1": [[0,2],[0,5],[0,7]],
      "spawn_team2": [[14,2],[14,5],[14,7]]
    },
    {
      "id": "industrial",
      "name": "Industrial Zone",
      "description": "Dense cover and narrow corridors between rusted structures.",
      "width": 15,
      "height": 10,
      "grid": [
        [0,2,0,0,0,0,2,0,2,0,0,0,0,2,0],
        [0,2,0,2,0,0,2,0,2,0,0,2,0,2,0],
        [0,0,0,2,0,0,0,0,0,0,0,2,0,0,0],
        [0,0,0,2,1,0,0,0,0,1,2,0,0,0,0],
        [0,0,0,0,0,0,0,0,0,0,0,0,0,0,0],
        [0,0,0,0,0,0,0,0,0,0,0,0,0,0,0],
        [0,0,0,2,1,0,0,0,0,1,2,0,0,0,0],
        [0,0,0,2,0,0,0,0,0,0,2,0,0,0,0],
        [0,2,0,0,0,0,2,0,2,0,0,0,0,2,0],
        [0,2,0,0,0,0,2,0,2,0,0,0,0,2,0]
      ],
      "spawn_team1": [[0,2],[0,5],[0,7]],
      "spawn_team2": [[14,2],[14,5],[14,7]]
    },
    {
      "id": "ruins",
      "name": "Shattered Ruins",
      "description": "A crumbling cityscape. Every corner hides an ambush.",
      "width": 15,
      "height": 10,
      "grid": [
        [0,0,0,2,2,0,0,0,0,2,2,0,0,0,0],
        [0,0,0,0,2,0,1,0,1,0,2,0,0,0,0],
        [0,1,0,0,0,0,0,2,0,0,0,0,0,1,0],
        [0,0,2,0,0,1,0,0,0,1,0,0,2,0,0],
        [0,0,0,0,0,0,2,0,2,0,0,0,0,0,0],
        [0,0,0,0,0,0,2,0,2,0,0,0,0,0,0],
        [0,0,0,0,0,1,0,0,0,1,0,0,0,0,0],
        [0,0,2,0,0,0,0,2,0,0,0,0,2,0,0],
        [0,0,0,0,2,0,1,0,1,0,2,0,0,0,0],
        [0,0,0,2,2,0,0,0,0,2,2,0,0,0,0]
      ],
      "spawn_team1": [[0,2],[0,5],[0,7]],
      "spawn_team2": [[14,2],[14,5],[14,7]]
    },
    {
      "id": "triangle",
      "name": "Triangle Protocol",
      "description": "Three-way standoff. One team holds high ground, two contest the flanks. 3-player map.",
      "width": 18,
      "height": 12,
      "grid": [
        [0,0,0,0,2,2,0,0,0,0,0,0,2,2,0,0,0,0],
        [0,0,0,0,2,0,0,0,0,0,0,0,0,2,0,0,0,0],
        [0,0,1,0,0,0,0,0,0,0,0,0,0,0,0,1,0,0],
        [0,0,0,0,2,0,0,0,0,0,0,0,0,2,0,0,0,0],
        [0,1,0,0,0,0,2,0,0,0,0,2,0,0,0,0,1,0],
        [0,0,0,0,0,0,0,0,1,1,0,0,0,0,0,0,0,0],
        [0,0,0,0,0,0,0,1,0,0,1,0,0,0,0,0,0,0],
        [0,0,0,2,0,0,0,0,0,0,0,0,0,0,2,0,0,0],
        [0,0,0,0,0,1,0,0,0,0,0,0,1,0,0,0,0,0],
        [0,1,0,0,0,0,0,0,0,0,0,0,0,0,0,0,1,0],
        [0,0,0,0,2,0,0,0,0,0,0,0,0,2,0,0,0,0],
        [0,0,0,0,0,0,0,0,0,0,0,0,0,0,0,0,0,0]
      ],
      "spawn_team1": [[0,7],[0,8],[0,9]],
      "spawn_team2": [[17,7],[17,8],[17,9]],
      "spawn_team3": [[8,0],[9,0],[9,1]]
    }
  ]
}
